R 1000 980
NO ./textures/WallBricks.xpm
SO ./textures/WallClear.xpm
WE ./textures/WallDoor.xpm
EA ./textures/WallBricksG.xpm

S ./textures/Hook.xpm
F 70,70,70
C 30,30,30

1111111111111111
1000000000000001
1001001020001001
1001001000001001
1001001000001001
1001001000001001
1000000000000001
1111111101111111
       1N1
       111