R 900 650
NO ./textures/WallBricks.xpm
SO ./textures/WallClear.xpm
WE ./textures/WallDoor.xpm
EA ./textures/WallBricksG.xpm

S ./textures/Hook.xpm
F 70,70,70
C 200,200,200

11111111111111111111
12020100001000000001
10000100000000000001
10000000000020001001
11001111110111101001
10000000000000001001
1000000000N000111001
10110111110101100001
10100000010110000001
10001100000000001101
11111111111111111111