R 800 600
NO ./texture/blue.xpm
SO ./texture/wood.xpm
WE ./texture/grey.xpm
EA ./texture/brick.xpm

S ./texture/barrel.xpm
F 220,100,0
C 225,30,0

    111111111111
    100000000001
    100000000001
1111100000000001
1000000020000001
1002000002000001
1000000002000001
1000000000000001
1000000000000001
1000000000000001
100000N000000001
1000000000000001
1000000000000001
1111111111111111
