R 800 600
NO ./texture/blue.xpm
SO ./texture/wood.xpm
WE ./texture/grey.xpm
EA ./texture/brick.xpm

S ./texture/barrel.xpm
F 220,100,0
C 225,30,0

11111111111
10000000001
10000000001
10000002001
10000000001
10000000001
10000000001
1000020N001
10020000001
11111111111
