R 901 651
NO ./textures/WallBricks.xpm
SO ./textures/WallClear.xpm
WE ./textures/WallDoor.xpm
EA ./textures/WallBricksG.xpm

S ./textures/Hook.xpm
F 70,70,70
C 30,30,30

        1111111111111111111111111
        1000000000110000000000001
        1011000001110000002000001
        1001000000000000000000001
111111111011000001110000000000001
100000000011000001110111111111111
11110111111111011000000002101
11110111111111011010101012201
11000000110101011010101010001
10002000000000001010101010001
10000000000000001010101010001
11000001110101011110101110N0111
11110111 1110101 101101010001
11111111 1111111 111111111111