R 800 600
NO ./texture/blue.xpm
SO ./texture/wood.xpm
WE ./texture/grey.xpm
EA ./texture/brick.xpm

S ./texture/barrel.xpm
F 70,70,70
C 200,200,200

11111111111111111111
10000000001000000001
10000000000000000001
10000000000000001001
10001000000000001001
10000000000000000001
1000000000N000000001
10000000000000000001
10000000000000000001
10000000000000000001
11111111111111111111