R 800 600
NO ./texture/blue.xpm
SO ./texture/wood.xpm
WE ./texture/grey.xpm
EA ./texture/brick.xpm

S ./texture/barrel.xpm
F 70,70,70
C 200,200,200

11111111111111111111111111111111111111
10001010100100000100000100000000000001
10010000000000000000000000111101001001
10110000011111111111111111111111111111
1000000001
1000000001
1000001001
1000000001
1000000111
1000000101
1001000001
1000000001
1000000011
1000000001
1000000011
10000000011111111111111111111111111111
10000000000000000000000100000001010001
100000000000E0000000000000000001000111
10000000000000000000000100000000010001
11111111111111111111111111111111111111