R 900 650
NO ./textures/WallBricks.xpm
SO ./textures/WallClear.xpm
WE ./textures/WallDoor.xpm
EA ./textures/WallBricksG.xpm

S ./textures/Hook.xpm
F 70,70,70
C 30,30,30

11111111111
10000000001
10022100001
10000200001
10000000001
10000N00001
10000000001
10000000001
10000000001
10000000001
10000000001
10000000001
10000000001
10000000001
10000000001
10000000001
10000000001
11111111111