R 800 600
NO ./texture/blue.xpm
SO ./texture/wood.xpm
WE ./texture/grey.xpm
EA ./texture/brick.xpm

S ./texture/barrel.xpm
F 220,100,0
C 225,30,0

    1111111
    1000001
    1000201
11111000001
10000000001
10020000001
10000000001
10000000001
10000000001
10000000001
100000N0001
10000000001
10000000001
11111111111
