{\rtf1\ansi\ansicpg1252\cocoartf2512
\cocoatextscaling0\cocoaplatform0{\fonttbl\f0\fnil\fcharset0 Menlo-Regular;}
{\colortbl;\red255\green255\blue255;}
{\*\expandedcolortbl;;}
\paperw11900\paperh16840\margl1440\margr1440\vieww15280\viewh13660\viewkind0
\pard\tx566\tx1133\tx1700\tx2267\tx2834\tx3401\tx3968\tx4535\tx5102\tx5669\tx6236\tx6803\pardirnatural\partightenfactor0

\f0\fs52 \cf0 R 1920 1080\
NO ./path_to_the_north_texture\
SO ./path_to_the_south_texture\
WE ./path_to_the_west_texture\
EA ./path_to_the_east_texture\
\
S ./path_to_the_sprite_texture\
F 220,100,0\
C 225,30,0\
\
        1111111111111111111111111\
        1000000000110000000000001\
        1011000001110000002000001\
        1001000000000000000000001\
111111111011000001110000000000001\
100000000011000001110111111111111\
11110111111111011100000010001\
11110111111111011101010010001\
11000000110101011100000010001\
10002000000000001100000010001\
10000000000000001101010010001\
11000001110101011111011110N0111\
11110111 1110101 101111010001\
11111111 1111111 111111111111}