R 1920 1080 
NO ./path_to_the_north_texture
SO ./path_to_the_south_texture
WE ./path_to_the_west_texture
EA ./path_to_the_east_texture
S ./path_to_the_sprite_texture
F 25,25,25
C 0,126,233

1111111111111111111111111111111111111111
1110000001001100001110000010001001010011
1100000101010002010001000010101101011101
1010000000000000110000000001010010111101
1101000100010001101000001010100101010001
1001011020010001010100001100110011010001
1000001000000010000101111001000100011001
1011000010101111000011111010001111000001
1001000011000111100000000100000000000101
1100100100001101100111001000001000010101
1000000001100000001000010101001111100001
1000100010101001010011010000010000100101
1001000001000000011000001000010010001001
1100010000010110010010000001110000010001
1001000010101100100100000011110001011011
1011010110101100010000011001010101111001
1200000012010111001000010000100000101001
1000010110011100001020010101000101110001
1000000001100100001101000001000110000011
101000001100011010000110000000010S010101
1011001000021001101011000110100001100101
1000001100000101000000001000001000102111
1000000010000000101100001010010100000101
1102000001000000010001000000001000010111
1001000001010001100000011101100011011001
1010010100001100000010010010011000000001
1001100000110001011000000100100111101101
1111100000101000021010001011111211000101
1010000100000010110100010100110100100001
1110001000010000011000010011000101000011
1101010000100000000100010110000010111001
1000002101011111010001000100011101000101
1100201101010000010001012010100110111001
1010001000001000010000000000101011100001
1110100000000000100000000020110000000101
1011100000000102001011000100110000000001
1000111000010000101001000000000100111001
1000110000000000000111110001201110001001
1010100010000000000100100000001100000101
1111111111111111111111111111111111111111
