R 10 100
NO ./textures/WallBricks.xpm
SO ./textures/WallClear.xpm
WE ./textures/WallDoor.xpm
EA ./textures/WallBricksG.xpm

S ./textures/Hook.xpm
F 70,70,70
C 30,30,30

11111111
10000001
10000001
10110001
10010201
10000001
10000N01
11111111